1111111111
1000010001
1011110101
1200112001
1100110001
1440204441
1000010111
1012112003
1011111111
1010021001
1210101011
1010101011
1002100211
1111111111

0000000000
0111100000
0100000000
0100000000
0000000200
0030000300
0000002000
0000000100
0000000000
0000000040
0000000000
0000000000
0000000000
0000000000
